2222222222
2001030212
2000000002
2000000002
2000000002
2000000002
2000000002
2001111002
2000000002
2222222222
